###################
#.................#
#.#####.#.#.#####.#
#.......#.#.......#
#.###.###.###.###.#
#.#.#.........#.#.#
#.###.#######.###.#
#.................#
###.#####.#####.###
#.................#
#.#######.#######.#
#.......#.#.......#
#.#####.#.#.#####.#
#.....#.....#.....#
#.#.#.#.#.#.#.#.#.#
#.#.#...#.#...#.#.#
#.#.#####.#####.#.#
#.................#
###################
