###################
#.................#
#.###.#.###.#.###.#
#.#.#.#.....#.#.#.#
#.###.#.#.#.#.###.#
#.....#.#.#.#.....#
#.#####.#.#.#####.#
#.#.............#.#
#.#.#####.#####.#.#
#.................#
#.#####.###.#####.#
#.......#.#.......#
#.###.#.###.#.###.#
#.#.#.#.....#.#.#.#
#.###.#.###.#.###.#
#.....#.#.#.#.....#
#.#####.###.#####.#
#.................#
###################
