###################
#.................#
#.#.###.#.#.###.#.#
#...#...#.#...#...#
#.###.#.#.#.#.###.#
#.....#.#.#.#.....#
#.###.#.#.#.#.###.#
#.#.....#.#.....#.#
#.#.#####.#####.#.#
#.................#
#.#.#####.#####.#.#
#.#.....#.#.....#.#
#.###.#.#.#.#.###.#
#.....#.#.#.#.....#
#.###.#.#.#.#.###.#
#...#...#.#...#...#
#.#.###.#.#.###.#.#
#.................#
###################
