###################
#.................#
#.#.#.#.###.#.#.#.#
#...#.#.....#.#...#
#.###.#.###.#.###.#
#.................#
#.#.###.#.#.###.#.#
#.#.....#.#.....#.#
#.#.###.#.#.###.#.#
#.................#
#.###.#.###.#.###.#
#...#.#.....#.#...#
#.#.#.#.###.#.#.#.#
#.................#
#.#.###.#.#.###.#.#
#.#.....#.#.....#.#
#.#.###.#.#.###.#.#
#.................#
###################
