###################
#...#.........#...#
#.#.#.#.###.#.#.#.#
#.#.....#.......#.#
#.#.#.#.#.#.#.#.#.#
#...#.........#...#
#.###.###.###.###.#
#...........#.....#
###.###.###.###.###
#.#.....#.#.....#.#
###.#.#.###.#.#.###
#.....#.....#.....#
#.#.#.###.###.#.#.#
#.................#
###.#.#.#.#.#.#.###
#...#...#.....#...#
#.#.#.#.###.###.#.#
#.................#
###################
